         ####                
         #  #                
         #  ########         
   #######  #      #         
   #   # # # # #   ##        
   #          ##    #        
  ###  # #  # #     #########
  #     #   # #    #   # #  #
 ## #   #     ###      # #  #
 #  #    # ###  #  #   # #  #
 #     ##    #   ##    # # ##
####    #    ##  #          #
#  #    ### #     ###  ###  #
#     ##              ##    #
#  ##  ##      ###  ##      #
## #     # #  ##  ##      ###
## ##     #   #  #      ###  
#      ####   #       ###    
#@  #  #  #  #     .###      
########  ###########        