###############
#             #
#   #  .  #   #
#   #     #   #
#   #######   #
#     ###     #
#    #####    #
#    #   #    #
#    # @ #    #
#    #   #    #
###############