
#########################################
#########         #######        ########
######             #####                #
#         @##       ##                  #
#         ####                         ##
##        ######                      ###
##        #####                       ###
##         ##                   ####  ###
##                 ##           #########
##                 ####     ##  #########
##     #######    #####   ###############
####   #######     ####   ##### #########
####                ##    ####  #########
###############                 #########
###############                 #########
###############  ####     ###   #########
###. ################     ###   #########
##       ############     ##  ###########
##       ########             ###########
##       #######              ###########
##                    ##      ###########
#####              #######    ###########
######## #      ## #######     ##########
#########################################
