########################
# #          ######### #
#   # ######   ##    # #
##### # #  # #    ## # #
#     #  # # # ####  # #
# ### ## # # # #    #  #
# # # ## # # # # ### . #
# # # #  # #   #   #   #
#   # # ## ## ####     #
##### #     # #   #### #
#   # ##### #   ###    #
#@#         ###     # ##
########################
