#####
#   ###
#     #
#   ###
#     #
# .   #
## $  #
####$##
#  $ ##
# @   #
###. .#
  #   #
  #####