########################
#      #     #####     #
##     #               #
##         #       #   #
##         #   #   #   #
#   #      #   #   #   #
#   #          #   # . #
#   #          #   #   #
#   #      #   #       #
#          #        #  #
# @    #   ##       #  #
#      #    ###     #  #
########################
