#########################
#           #           #
#           #           #
#           #           #
#           #           #
#    .      #           #
#                       #
#           #           #
#           #           #
#           #           #
#           #           #
#           #           #
###### ########### ######
#           #           #
#           #           #
#           #           #
#           #           #
#           #           #
#                       #
#           #      @    #
#           #           #
#           #           #
#           #           #
#           #           #
#########################
