#########################
#           #           #
#           #           #
#           #           #
#           #           #
#           #      @    #
#                       #
#           #           #
#           #           #
#           #           #
#           #           #
#           #           #
###### ########### ######
#           #           #
#           #           #
#           #           #
#           #           #
#           #           #
#                       #
#    .      #           #
#           #           #
#           #           #
#           #           #
#           #           #
#########################
