########################
#      #       #     . #
#              #       #
#      #       #       #
#      #               #
#      #       #       #
#      #       #       #
## ######## ####### ####
#      #       #       #
#              #       #
#      #       #       #
#      #       #       #
#      #               #
#      #       #       #
#### ######## ####### ##
#      #       #       #
#      #       #       #
#      #               #
#      #       #       #
#              #       #
#@     #       #       #
########################
