########################
#      #       #     . #
#              #       #
#      #       #       #
#      #       #       #
#      #       #       #
#      #       #       #
## ######## ###### #####
#      #       #       #
#      #       #       #
#      #       #       #
#      #       #       #
#      #               #
#      #       #       #
#### #### ########### ##
#      #       #       #
#      #       #       #
#      #               #
#      #       #       #
#      #       #       #
#@     #       #       #
########################
