########################
#.       #             #
#        #             #
#                  #   #
#        #         #   #
#        #         #   #
##########         #   #
#        #         #   #
#        #         #   #
#                  #   #
#        #             #
#@       #             #
########################
