########################
#.       #    #        #
#        #    #    #   #
#             #    #   #
#        #    #    #   #
#        #         #   #
####################   #
#        #         #   #
#        #    #    #   #
#             #    #   #
#        #    #    #   #
#@       #    #        #
########################
