########################
# @ #    #     #   # . #
#   #    #     #   #   #
#   #    #     #   #   #
#   #    #     #   #   #
#   #    #     #   #   #
#   #    #     #   #   #
#   #    #     #   #   #
#   #    #     #   #   #
#   #    #     #   #   #
#                      #
#                      #
########################
